10 12
02 03 03 03 03 03 03 03 03 04
11 23 23 23 23 23 23 23 23 12
11 00 00 00 00 00 00 00 00 12
11 00 10 08 08 08 06 00 00 12
33 27 34 -1 -1 -1 11 00 00 12
-1 -1 -1 -1 -1 -1 11 00 00 12
-1 -1 -1 -1 -1 -1 11 00 00 12
-1 -1 -1 -1 -1 -1 11 00 00 12
-1 -1 -1 -1 -1 -1 11 00 00 12
-1 -1 -1 -1 -1 28 01 00 00 12
-1 -1 -1 -1 -1 24 23 00 00 12
-1 -1 -1 -1 -1 30 08 08 08 09
1 3 0
5 10
8
2 1 1 2 0 1 1 1
2 4 2 0 0 1 1 1
2 5 1 2 0 1 1 1
2 8 2 0 0 1 1 1
2 8 3 3 0 1 1 1
2 7 6 1 0 1 1 1
2 8 7 3 0 1 1 1
2 7 10 1 0 1 1 1
0