9 9
-1 -1 -1 02 03 04 -1 -1 -1
-1 02 03 01 23 05 03 04 -1
-1 11 23 23 00 23 23 12 -1
28 01 00 10 08 06 00 05 29
24 23 00 12 -1 11 00 23 25
30 06 00 05 03 01 00 10 31
-1 11 00 23 23 23 00 12 -1
-1 07 08 06 00 10 08 09 -1
-1 -1 -1 07 08 09 -1 -1 -1
1 4 1
8 4
12
3 2 2 0 0 45 15
3 2 3 0 35 45 15
3 2 4 0 0 45 15
3 2 5 0 35 45 15
3 2 6 0 0 45 15
3 6 2 0 0 45 15
3 6 3 0 35 45 15
3 6 4 0 0 45 15
3 6 5 0 35 45 15
3 6 6 0 0 45 15
0 2 2 1 0 4 0
0 6 6 3 0 4 0
2
4 1
4 7